NO ./path_to_the_north_texture
SO ./path_to_the_south_texture
WE ./path_to_the_west_texture
EA ./path_to_the_east_texture

F 220,100,0
C 225,30,0

111111111111111111111111111
1E0000000000000000000011111
111100000100000000000011111
100100000000000000111111111
111111111011000001110000001
100000000011000001110111111
111101111111110111000000101
111101111111110111010100101
110000001101010111000000101
100000000000000011000000101
100000000000000011010100101
110000011101010111110111101
11110111 1110101 1011110101
111111111111111111111111111