NO ./ASSET/wall_north.xpm
SO ./ASSET/wall_south.xpm
WE ./ASSET/wall_west.xpm
EA ./ASSET/wall_east.xpm

F 45, 67, 86
C 67, 91, 102

11111111111   11111111111111
1E000000001   1000000000011111
11110002011   1000D00002011111
10010000001   1000000111111111
111101111111111000001110000001
100000000011000001111111111
111101111111110111000000101
111101111111110111010100101
110000001101010111000200101
1000D0000000000011000000101
100000020000000011010100101
110000011101010111110111101
11110111 1110101 1011110101
111111111111111111111111111