NO ./ASSET/wall_north.xpm
SO ./ASSET/wall_south.xpm
WE ./ASSET/wall_west.xpm
EA ./ASSET/wall_east.xpm
DO ./ASSET/door2.xpm

F 92,131,116
C 202,237,255


11111111111111111111111111111111111111111111111111111111111111111111111111111111
10000000000000000000100000000000000000000000000000000000000000000000000000000001
100S0000001000000000100000000000000000000000000000000000000000000000000000000001
10000000001000000000100000000000000000000000010000000000000000000000000000000001
111D1111111011111111100000000000001000000000010000000000000000000000000000000001
10000000000020000000100000000000001000000000010000000000000000000000000000000001
10000000000000000000100000000000001000000000010000000000000000000000000000000001
10000000000000000000100000000000001000000000010000000000000000000000000000000001
10000000000000000000100000000000001000000000010000000000000000000000000000000001
10000000000000000000100000000000001000000000010000000000000000000000000000000001
100000000000000000001000000000000010000000000100000000000000000000000000000000011111111111111111111111
100000000200000000001000000000000010000000000000000000000000000000000000000000000000000000000000000001
100000000000000000001111111111111110000000000000000000000000000000000000000000000000000000000000000001
100000000000000000000000000000000000000000000000000000000000000000000000000000000000000000000000000001
100000000000000000000000000000000000000000000000000000000000000000000000000000000000000000000000000001
100000000000000000000000000000000000000000000000000000000000000000000000000000000000000000000020000001
100000000000000000000000000000000000000000000000000000000000000000000000000000000000000000000000000001
100000000000000000000000000000000000000000000000000000000001000000000000000000000000000000000000000001
100000000200000000000000000000000000000000000000000000000000000000020000000000000000000000000000000001
100000000000000000000000000000000000000000000000000000000000000000000000000000000000000000000000000001
100000000000000111111111100111111111000000000000000000000000000000000000000000000000000000000000000001
100000000000000100000000000000000001000000000000000000000000000000000000000000011111111111111111111111
10000000000000010000000111110000000100000000000000000000000000000000000000000001
100000000000000100000001   10000000100000000000000000000000000000000000000000001
100000000000000100000001   10000000100000000000000000000000000000000000000000001
10000000000000010000000111110000000100000000000000000100000000000000000000000001
10000000000000010000000000000000000100000000000000000000000000000000000000000001
10000000000000011111111111111111111100000000000000000000000000000200000000000001
10200000010111110000000000000000000000000000000000000000000000000000000000000001
10000000010000000000000000000000000000000000000000000000000000000000000000000001
10000000010000000000000000000000000000000000000000000000000000000000000000000001
10000000010000000000000000000000000000000000000000000000000000000000000000000001
10000000010000000000000000000000000000000000000000000000000000000000000000000001
10000000010000000000000020000000000000000000000000000000000000000000000000000001
10000000010000000000000000000000000000000000000000000000000000000000000000000001
10000000010000000000000000000000000000000000000000000000000000000000000000000001
11111111111111111111111111111111111111111111111111111111111111111111111111111111