NO ./ASSET/wall_north.xpm
SO ./ASSET/wall_south.xpm
WE ./ASSET/wall_west.xpm
EA ./ASSET/wall_east.xpm
DO ./ASSET/door.xpm

F 45, 67, 86
C 67, 91, 102

1111111111
1000000001
1111000001
1000000001
1000000001
1000000001
1000000001
1000000001
1000000001
1000000001
1000000001
1000000001
1000000001
1002000001
1000000001
1000000001
1000000001
1000000001
1000000001
1000000001
1000000001
1000000001
1000000201
1000000001
1000000001
1000000001
1000000001
1000000001
1000000001
1000000001
1000000001
1000000001
1000000001
1000000001
1000000001
1000000001
1000000001
1000000001
1000000001
1000000001
1000000001
1000000001
1000000001
1000000001
1000000001
1000000001
1000000001
1000000001
1000000001
1000000001
1000000001
1000000001
1000000001
1000000001
1000000001
1111D11111
1000000001
1000000001
1000000001
1200000001
1000000001
1000000001
100N001001
1000001001
102000100111111111
111111100000000001
      100020000001
      100000000001
      100001110111
      100001000001
      100001000001
      111111111111