NO ./textures/bluestone.xpm

SO ./textures/colorstone.xpm
WE ./textures/greystone.xpm
EA ./textures/redbrick.xpm


DO ./ASSET/door.xpm


F 202,237,255
C 92,131,116

1111111111
1000D00001
11D1100201
1000000001
100S001001
1000001021
1002001001
1111111111